10 10
0 0 0 0 0 0 0 0 0 0
0 3 1 1 2 1 1 1 1 0
0 3 1 1 2 1 1 1 1 0
0 3 1 1 2 1 1 1 1 0
0 1 1 5 5 6 1 1 1 0
0 1 2 1 1000 1 1 1 1 0
0 1 1 6 6 5 1 1 1 0
0 1 1 1 1 1 1 1 1 0
0 3 1 1 1 1 1 1 1 0
0 0 0 0 0 0 0 0 0 0