8 8 
0 0 0 0 0 0 0 0 
0 3 1000 1 3 0 1 0
0 2 2 1 1 1 0 0 
0 1 1 1 1 1 1 0 
0 1 1 1 1 1 1 0 
0 1 1 2 1 1 1 0 
0 3 1 1 2 1 3 0 
0 0 0 0 0 0 0 0 
